Population	Super Population	Structure	Cryptic Relatedness
ACB	AFR	NO	YES+
ASW	AFR	NO	YES+
ESN	AFR	NO	YES+
GWD	AFR	NO	YES+
LWK	AFR	NO	NO
MSL	AFR	NO	YES+
YRI	AFR	NO	YES
CLM	AMR	YES+	YES+
MXL	AMR	NO	NO
PEL	AMR	YES+	YES+
PUR	AMR	YES+	YES+
CDX	EAS	NO	NO
CHB	EAS	NO	NO
CHS	EAS	NO	YES
JPT	EAS	NO	NO
KHV	EAS	NO	YES+
CEU	EUR	NO	YES+
FIN	EUR	NO	NO
GBR	EUR	NO	YES
IBS	EUR	NO	YES+
TSI	EUR	NO	YES+
BEB	SAS	NO	YES
GIH	SAS	YES+	YES+
ITU	SAS	NO	YES+
PJL	SAS	NO	NO
STU	SAS	NO	YES+
